###############
#.............#
#.###.#######.#
#.#...#.#...#.#
###.###.#.#.#.#
#...#.#...#.#.#
#.###.#####.#.#
#.....#.....#.#
#######.#####.#
#.....#.#.....#
###.#.#.#.#####
#...#...#.#...#
#.#######.#.#.#
#...........#.#
###############
