###############
# # #   # # # #
# # ### # # # #
# #     # # # #
# ##### # # # #
#   #         #
### ##### #####
# #   # #     #
# ### # # #####
#       #     #
# # ### # #####
# # #       # #
# # # # # # # #
# # # # # #   #
###############
