####################
#       # #         
####### # # # ######
# #   #     #       
# ### ##### ### # # 
#   #         # # # 
### ### # ##### ### 
#       # #   # #   
##### # ### # ##### 
#     #   # #   # # 
# ### ### # ##### # 
# #     #     #     
### # ### ### ### # 
# # #   #   #   # # 
# # ### # # # ### # 
#     # # # # #   # 
### # # ### ##### ##
#   # #   # #       
# # ### ####### ### 
# #   # #         # 
