#####################
# # #   #       #   #
# # ### ### # ### # #
#       # # #     # #
##### ### # ####### #
# #   #   #   # # # #
# ### ### # ### # ###
#     #   #       # #
##### ### # ### # # #
# #           # #   #
# # # # ### # # ### #
#   # # #   # #   # #
### # ### # ### #####
#   #   # # #       #
# # # ########### ###
# # #     #     #   #
### # ##### # #######
#   #       #       #
# # # ### # ### ### #
# # #   # # #     # #
#####################
