#########################
#   #   #     #   # #   #
# ##### ### ### ### # ###
#   #   #       #       #
# ##### ##### ### ##### #
#     # #   #       # # #
# ##### # # # ##### # ###
#         # #   # #   # #
### ####### # ### ##### #
# # #     #             #
# ####### ### ###########
#                     # #
##### ### # ### # ##### #
# # # #   #   # #       #
# # # ### # ### ### ### #
#     #   # #   #     # #
# # # ### # # ### ### ###
# # # #   # #   # #     #
# # # # # # # ### ### # #
# # # # # # # # # #   # #
# # # ### ### # # ### ###
# # # #     # # #   # # #
### ##### ### # ##### # #
#   #     #       #     #
#########################
