#########################
# # # #             #   #
# # # ##### ####### # ###
#               #     # #
# ################### # #
# #   #   #   #   #   # #
### # ### ### ### # # # #
#   # # # # # #     #   #
##### # # # # ### ### # #
# # #             #   # #
# # ### ### # ##### #####
#       #   #   #       #
##### # ### # ##### # # #
#     # #   # #     # # #
# ### ##### # # ### ### #
# #   #     # #   # #   #
# # # ##### # # # ### # #
# # #   #   # # # #   # #
# # ####### # ### ### # #
# # #       #   # # # # #
# ####### # ####### ### #
#     #   # #   #   # # #
# ######### # # ### # # #
#     #     # #         #
# # ### ### # # # # ### #
# #   # #   # # # #   # #
