###############################
#...#...........#.....#.#.....#
###.#.#####.#####.#.#.#.#####.#
#...#.#.....#.....#.#.#.......#
#.###.#.#####.#####.#.#######.#
#.....#.....#.#...#.#.....#...#
#.#########.#.#.#.#.#####.#.###
#...#.....#...#.#.#.....#.#...#
###.#.#.#####.#.#.#####.#####.#
#...#.#.#...#...#...#.#.....#.#
#.###.###.#.#######.#.###.###.#
#.....#...#...#...#...#.#...#.#
###.###.#####.#.#.###.#.###.#.#
#...#...#.#...#.#.#...#...#.#.#
#.###.###.#.###.#.###.#.#.#.#.#
#.#.#...#.....#.#...#.#.#.#.#.#
#.#.###.#####.#.###.#.#.###.#.#
#...#.#...#.#.#.#...#...#...#.#
###.#.###.#.#.#.#.#######.#.#.#
#.#...#.#.#.....#.......#.#.#.#
#.###.#.#.#############.#.#.#.#
#.#...#.#.#...........#...#.#.#
#.#.###.#.#.#########.#######.#
#.#.#...#.#.#.......#.......#.#
#.#.#.###.#.#.#####.#######.#.#
#...#.#...#...#.....#.....#...#
#.###.#.#######.#####.###.#####
#.#...#.#.....#...#...#.#.#...#
#.#.#.#.#.###.###.#.###.#.###.#
#...#.#.....#.......#.........#
###############################
